 111111111111111111111111
1000000000110000000000001
1011000001110000000000001
1001000000000000000000001
111111111011000001110000011
100000000011000001110111111111111
111101111111110111100000010001
111101111111110111010100100001
110000001101010111000000000011
1000000  0000000000000000010001
1     0000000000011000101100011
11000001010101010111011110N0111
11110111111101011101111010001
11111111 1111111  11111111111
000000000000
011111111110
010000000010
011111111110
000000000000