

      F 105,105,135






        C 225,30,0

SO ./assets/textures/purple_stone.xpm









     NO ./assets/textures/red_brick.xpm

WE ./assets/textures/blue_stone.xpm






  EA ./assets/textures/grey_stone.xpm





 111111111111111111111111
1000000000110000000000001
10  1
1011000001110000000000001
1001000000000000000000001
111111111011000001110000011
100000000011000001110111111111111
111101111111110111100000010001
11110111111111011101010010001
110000001101010111000000000011
1000000  0000000000000000010001
1     0000000000011000101100011
11000001110101011111011110N0111
11110111 1110101 101111010001
11111111 1111111  11111111111
