      F 205,92,92
        C 223,255,0

SO ./assets/south_texture.xpm
     NO ./assets/north_texture.xpm
WE ./assets/west_texture.xpm
  EA ./assets/east_texture.xpm

 111111111111111111111111
1000000000110000000000001111
1011000001110000000000000001
100100000000000000000000111
111111111011000001110000011
1000000000110000011101100011
11110111111111011101010010001
110000001101010111000000000011
1000000  0000000000000000010001
1     0000000000011000101100011
11000001110101011111011110W0111
11110111 1110101 101111010001
11111111 1111111  11111111111
000000000000
011111111110
010000000010
011111111110
000000000000
