   WE                            sprites/east_wall.xpm
NO      ./sprites/east_wall.xpm   dsf
SO ./sprites/east_wall.xpm

F 255, 255, 255
EA ./sprites/east_wall.xpm
C   	 0, 0, 0

 1111    111011111111111111111111110
111111111111100000000000000000000001
 1000000000000000000000011111111111111
10000000000000000000001
100000000000000000000001
100000000000000000000001
100000000000000000000001
100000111110000101010001
100000100010000000000001
10000010N010000100010001
100000100010000000000001
1000001111000010101000010
100000000000000000000001
100000000000000000000001
1000000000000000000000010
100000000000000000000001
100000000000000000000001
100000000000000000000001
1000000000000000000000010
111111111000000000000001
10010000100000000000000
10000010100000000000000
10010000100000000000000
100111111000000000000001
100000000000000000000001
100000000000000000000001
111111111111111111111111
