SO ./assets/textures/mossy.xpm
NO ./assets/textures/mossy.xpm
WE ./assets/textures/mossy.xpm
EA ./assets/textures/mossy.xpm

F 55,53,10
C 80,80,4

1111111111111111111111111
1000000000110000000000001
1011000001110000000000001
10010000000000000000000011
111111111011000001110000N1
10000000001100000111011111111
11110111111111011100000010001
11110111111111011101010010001
11000000110101011100000000001
10000000000000000000000010001
10000000000000001101010010001
11000001110101011111011000011
11110111 1110101 111111010001
11111111 1111111 111111111111