NO ./sprites/north_wall.xpm wall1
SO ./sprites/south_wall.xpm
WE ./sprites/west_wall.xpm
EA ./sprites/east_wall.xpm

F 0,120,0
C 0,0,120

1111111111111111111111111111111111111
1011000000000000000000000000000000001
1001000000000000000000000000000000001
1001100000000000000000000000000000001
1000000000010000000000000000000000001
1111100000010000000W00000000000000001
1000000000010000000000000000000000001
1001000000000000000000000000100000001
1111111111111111111111111111111111111
